
player,1,1

MMMMMMMMMMMMMMMMMMMMMMMMMMMMMMMMMMMMMM

MOOOOOOOOOOOOOOOOOMMMMMMMMMMMOOOOOOOOM

MOOOOOOOOOOOOOOOOOMMMMMMMMMMMOOOOOOOOM

MOOOOOOOOOOOOOOOOOMMMMMMMMMMMOOOOOOOOM

MOOOOOOOOOOOOOOOOOMMMMMMMMMMMOOOOOOOOM

MOOOOOOOOOOOOOOOOOMMMMMMMMMMMOOOOOOOOM

MOOOOOOOOOOOOOOOOOMMMMMMMMMMMOOOOOOOOM

MOOOOOOOOOOOOOOOOOMMMMMMMMMOOOOOOOOOOO

MOOOOOOOOOOOOOOMMOMMMMMMMMMOMMMMMMMMMM

MOOOOOOOOOOOOOOMMOMMMMMMMMMOMMMMMMMMMM

MOOOOOOOOOOOOOOMMOMOOOOOOOOOMMMMMMMMMM

MOOOOOOOOOOOOOOMMOMOOOOOOOOOMMMMMMMMMM

MOOOOOOOOOOOOMMMMOMOOOOOOOOOMMMMMMMMMM

MOOOOOOOOOOOOMMMMOMOOOOOOOOOMMMMMMMMMM

MOOOOOOOOOOOOMMMMOMOOOOOOOOOMMMMMMMMMM

MOOOOOOOOOMMMMMMMOMOOOOOOOOOMMMMMMMMMM

MOOOOOOOOOMMMMMMMOOOOOOOOOOOMMMMMMMMMM

MMMMMMMMMMMMMMMMMMMMMMMMMMMMMMMMMMMMMM