s_Enemy,19,1

s_Enemy,37,10

enemy,22,24,1

enemy,30,35,10

map,47,10,10,1,maps/map2.txt

player,1,1

MMMMMMMMMMMMMMMMMMMMMMMMMMMMMMMMMMMMMMMMMMMMMMMMMMMMMMMMMMMMMMM

MOOOOOOOOOOOOOOOOOMMMMMMMMMMMOOOOOOOOMMMMMMMMMMMMMMMMMMMMMMMMMM

MOOOOOOOOOOOOOOOOOMMMMMMMMMMMOOOOOOOOMMMMMMMMMMMMMMMMMMMMMMMMMM

MOOOOOOOOOOOOOOOOOMMMMMMMMMMMOOOOOOOOMMMMMMMMMMMMMMMMMMMMMMMMMM

MOOOOOOOOOOOOOOOOOMMMMMMMMMMMOOOOOOOOMMMMMMMMMMMMMMMMMMMMMMMMMM

MOOOOOOOOOOOOOOOOOMMMMMMMMMMMOOOOOOOOMMMMMMMMMMMMMMMMMMMMMMMMMM

MOOOOOOOOOOOOOOOOOMMMMMMMMMMMOOOOOOOOMMMMMMMMMMMMMMMMMMMMMMMMMM

MOOOOOOOOOOOOOOOOOMMMMMMMMMOOXOOOOOOXOOOOOOOOOOOOOOOOOOOOOOOOOO

MOOOOOOOOOOOOOOMMOMMMMMMMMMOMMMMMMMMMMMMMMMMMMMMMMMMMMMMMMMMMMM

MOOOOOOOOOOOOOOMMOMMMMMMMMMOMMMMMMMMMMMMMMMMMMMMMMMMMMMMMMMMMMM

MOOOOOOOOOOOOOOMMOMOOOOOOOOOMMMMMMMMMMMMMMMMMMMMMMMMMMMMMMMMMMM

MOOOOOOOOOOOOOOMMOMOOOOOOOOOMMMMMMMMMMMMMMMMMMMMMMMMMMMMMMMMMMM

MOOOOOOOOOOOOMMMMOMOOOOOOOOOMMMMMMMMMMMMMMMMMMMMMMMMMMMMMMMMMMM

MOOOOOOOOOOOOMMMMOMOOOOOOOOOMMMMMMMMMMMMMMMMMMMMMMMMMMMMMMMMMMM

MOOOOOOOOOOOOMMMMOMOOOOOOOOOMMMMMMMMMMMMMMMMMMMMMMMMMMMMMMMMMMM

MOOOOOOOOOMMMMMMMOMOOOOOOOOOMMMMMMMMMMMMMMMMMMMMMMMMMMMMM

MOOOOOOOOOMMMMMMMOXOOOOOOOOOMMMMMMMMMMMMMMMMMMMMMMMMMMMMM

MMMMMMMMMMMMMMMMMMMMMMMMMMMMMMMMMMMMMMMMMMMMMMMMMMMMMMMMM