s_Enemy,19,1

s_Enemy,37,10

enemy,21,24,1

enemy,30,35,10

player,1,1

MMMMMMMMMMMMMMMMMMMMMMMMMMMMMMMMMMMMMM

MOOOOOOOOOOOOOOOOOMMMMMMMMMMMOOOOOOOOM

MOOOOOOOOOOOOOOOOOMMMMMMMMMMMOOOOOOOOM

MOOOOOOOOOOOOOOOOOMMMMMMMMMMMOOOOOOOOM

MOOOOOOOOOOOOOOOOOMMMMMMMMMMMOOOOOOOOM

MOOOOOOOOOOOOOOOOOMMMMMMMMMMMOOOOOOOOM

MOOOOOOOOOOOOOOOOOMMMMMMMMMMMOOOOOOOOM

MOOOOOOOOOOOOOOOOOMMMMMMMMMOOXOOOOOOXO

MOOOOOOOOOOOOOOMMOMMMMMMMMMOMMMMMMMMMM

MOOOOOOOOOOOOOOMMOMMMMMMMMMOMMMMMMMMMM

MOOOOOOOOOOOOOOMMOMOOOOOOOOOMMMMMMMMMM

MOOOOOOOOOOOOOOMMOMOOOOOOOOOMMMMMMMMMM

MOOOOOOOOOOOOMMMMOMOOOOOOOOOMMMMMMMMMM

MOOOOOOOOOOOOMMMMOMOOOOOOOOOMMMMMMMMMM

MOOOOOOOOOOOOMMMMOMOOOOOOOOOMMMMMMMMMM

MOOOOOOOOOMMMMMMMOMOOOOOOOOOMMMMMMMMMM

MOOOOOOOOOMMMMMMMOXOOOOOOOOOMMMMMMMMMM

MMMMMMMMMMMMMMMMMMMMMMMMMMMMMMMMMMMMMM