s_Enemy,19,1

s_Enemy,37,10

enemy,21,24,1

enemy,30,35,10

map,47,10,10,1,maps/map2.txt

player,1,1

MMMMMMMMMMMMMMMMMMMMMMMMMMMMMMMMMMMMMMMMMMMMMMMMMMMMMMMMM

MOOOOOOOOOOOOOOOOOMMMMMMMMMMMOOOOOOOOMMMMMMMMMMMMMMMMMMMM

MOOOOOOOOOOOOOOOOOMMMMMMMMMMMOOOOOOOOMMMMMMMMMMMMMMMMMMMM

MOOOOOOOOOOOOOOOOOMMMMMMMMMMMOOOOOOOOMMMMMMMMMMMMMMMMMMMM

MOOOOOOOOOOOOOOOOOMMMMMMMMMMMOOOOOOOOMMMMMMMMMMMMMMMMMMMM

MOOOOOOOOOOOOOOOOOMMMMMMMMMMMOOOOOOOOMMMMMMMMMMMMMMMMMMMM

MOOOOOOOOOOOOOOOOOMMMMMMMMMMMOOOOOOOOMMMMMMMMMMMMMMMMMMMM

MOOOOOOOOOOOOOOOOOMMMMMMMMMOOXOOOOOOXOOOOOOOOOOOOOOOOOOOO

MOOOOOOOOOOOOOOMMOMMMMMMMMMOMMMMMMMMMMMMMMMMMMMMMMMMMMMMM

MOOOOOOOOOOOOOOMMOMMMMMMMMMOMMMMMMMMMMMMMMMMMMMMMMMMMMMMM

MOOOOOOOOOOOOOOMMOMOOOOOOOOOMMMMMMMMMMMMMMMMMMMMMMMMMMMMM

MOOOOOOOOOOOOOOMMOMOOOOOOOOOMMMMMMMMMMMMMMMMMMMMMMMMMMMMM

MOOOOOOOOOOOOMMMMOMOOOOOOOOOMMMMMMMMMMMMMMMMMMMMMMMMMMMMM

MOOOOOOOOOOOOMMMMOMOOOOOOOOOMMMMMMMMMMMMMMMMMMMMMMMMMMMMM

MOOOOOOOOOOOOMMMMOMOOOOOOOOOMMMMMMMMMMMMMMMMMMMMMMMMMMMMM

MOOOOOOOOOMMMMMMMOMOOOOOOOOOMMMMMMMMMMMMMMMMMMMMMMMMMMMMM

MOOOOOOOOOMMMMMMMOXOOOOOOOOOMMMMMMMMMMMMMMMMMMMMMMMMMMMMM

MMMMMMMMMMMMMMMMMMMMMMMMMMMMMMMMMMMMMMMMMMMMMMMMMMMMMMMMM