s_Enemy,26,10

player,1,6

.........M
.........M
.........M
.........M
MMMMMMMMMM
M....................................
M....................................
M....................................
M....................................
M....................................
MMMMMM...MMMMMM...............MMMMMMM
MMMMMM...MMMMMM...............MMMMMMM
MMMMMM...MMMMMM...............MMMMMMM
MMMMMM...MMMMMM...............MMMMMMM
MMMMMMWWWMMMMMMWWWWWWWWWWWWWWWMMMMMMM
MMMMMMMMMMMMMMMMMMMMMMMMMMMMMMMMMMMMM