player,1,5

MMMMMMOm

MMMMMMOM

MMMMMMOM

MMMMMMOM

MMMMMMMM