
enemy,3,9,1

enemy,3,7,2

s_Enemy,7,3

s_Enemy,12,1

player,2,2

map,22,4,1,4,maps/test.txt

MMMMMMMMMMMMMMMMMMMMMMM

MOOOOOOOOOOOOOOOOOOOOOO

MOOOOOOOOOOOOOOOOOOOOOO

MDOOOOOOOOOOOOOOOOOOOOO

MXXOOOOOOXOWOOOOOOOOOOO

MMMMMMOOOMMMOOOOOOOOOMM

MOOOOOOOOOMOOOOMOOOOMMM

MOOOOOOOOOOOOOOSOOAMMMM

MMMMMMMMMMMMMMMMMMMMMMM