Enemy,3,9,1
Enemy,3,7,2
S_Enemy,7,3
S_Enemy,12,1
Player,2,2
MMMMMMMMMMMMMMMMMMMMMMM
MOOOOOOOOOOOOOOOOOOOOOM
MOOOOOOOOOOOOOOOOOOOOOM
MOOOWASDOOOOOOOOOOOOOOM
MXXOOOOOOOXOOOOOOOOOOOM
MMMMMMOOOMMMOOOOOOOOOMM
MOOOOOOOOOMOOOOOOOOOMMM
MOOOOOOOOOOOOOOOOOOMMMM
MMMMMMMMMMMMMMMMMMMMMMM
