Enemy,2,8,1
S_Enemy,7,3
S_Enemy,12,1
Player,2,2
OOOOOOOOOOOOOOOOOOOOOO
MXXOOOOOOOXOOOOOOOOOOO
MMMMMMOOOMMMOOOOOOOOOM
MOOOOOOOOOMOOOOOOOOOMM
MOOOOOOOOOOOOOOOOOOMMM
MMMMMMMMMMMMMMMMMMMMMM
