Enemy,4,0,1
S_Enemy,1,2
MMMMMMMMMMMMMMMMM
MOOOOOOOOOOOOOOOO
MOOOOOOOOOOOOOOOO
MOOOOOOOOOOOOOOOO
MOOOOOOOOOOOOOOOO
MOOOOOOOOOOOOOOOO
MOOOOOOOOOOOOOOOO
MOOOOOOOOOOOOOOOO
MXPOOOMOOOMOOOOOO
MMMMMMMMMMMMMMMMM
