Enemy,2,8,1
S_Enemy,7,3
S_Enemy,12,1
Player,2,2
MMMMMMMMMMMMMMMMMMMMMMM
MOOOOOOOOOOOOOOOOOOOOOM
MOOOOOOOOOOOOOOOOOOOOOM
MOOOOOOOOOOOOOOOOOOOOOM
MXXOOOOOOOXOOOOOOOOOOOM
MMMMMMOOOMMMOOOOOOOOOMM
MOOOOOOOOOMOOOOOOOOOMMM
MOOOOOOOOOOOOOOOOOOMMMM
MMMMMMMMMMMMMMMMMMMMMMM
