player,2,2

map,3,1,10,8,maps/boss.txt

MMMMMMMMMMMMMMMMMMMMMMM

MOOOOOOOOOOOOOOOOOOOOOM

MOOOOOOOOOOOOOOOOOOOOOM

MOOOOOOOOOOOOOOOOOOOOOM

MOOOOOOOOXOWOOOOOOOOOOM

MMMMMMOOOMMMOOOOOOOOOMM

MOOOOOOOOOMOOOOMOOOOMMM

MOOOOOOOOOOOOOOSOOAMMMM

MMMMMMMMMMMMMMMMMMMMMMM